111111111111111111
100P00000000000001
1111111C1111111111
1000000000000000C1
1E0000000011111111
111111111111111111