111111111111111111
100P00000000000001
1011111E1111111101
1000000000000000C1
1C0000000011111111
111111111111111111